10 10
##########
#        #
#   I    #
#   C    #
#        #
#   P    #
#        #
#        #
#        #
##########
