7
10
#######
I C C##
I  C C 
I    CP
#######
#######
##CCC##
##CcC##
##CCC##
#######